"GEOID","NAME","B25003_001E","B25003_001M","B25003_002E","B25003_002M","B25003_003E","B25003_003M"
"51540000201","Census Tract 2.01, Charlottesville city, Virginia",1146,188,270,68,876,187
"51540000202","Census Tract 2.02, Charlottesville city, Virginia",1544,256,190,115,1354,245
"51540000302","Census Tract 3.02, Charlottesville city, Virginia",1607,280,633,165,974,239
"51540000401","Census Tract 4.01, Charlottesville city, Virginia",1471,169,721,180,750,155
"51540000402","Census Tract 4.02, Charlottesville city, Virginia",2128,207,1196,199,932,244
"51540000501","Census Tract 5.01, Charlottesville city, Virginia",1666,178,615,199,1051,189
"51540000502","Census Tract 5.02, Charlottesville city, Virginia",2033,223,872,207,1161,210
"51540000600","Census Tract 6, Charlottesville city, Virginia",1275,151,96,52,1179,163
"51540000700","Census Tract 7, Charlottesville city, Virginia",1651,171,828,98,823,150
"51540000800","Census Tract 8, Charlottesville city, Virginia",1451,176,971,162,480,118
"51540000900","Census Tract 9, Charlottesville city, Virginia",884,100,571,89,313,79
"51540001000","Census Tract 10, Charlottesville city, Virginia",1958,309,587,163,1371,279
"51109950101","Census Tract 9501.01, Louisa County, Virginia",1039,199,885,211,154,93
"51109950102","Census Tract 9501.02, Louisa County, Virginia",1818,194,1482,177,336,142
"51109950201","Census Tract 9502.01, Louisa County, Virginia",2290,250,1312,181,978,230
"51109950202","Census Tract 9502.02, Louisa County, Virginia",1731,202,1410,225,321,131
"51109950301","Census Tract 9503.01, Louisa County, Virginia",1299,144,1178,144,121,87
"51109950302","Census Tract 9503.02, Louisa County, Virginia",1275,233,978,241,297,172
"51109950303","Census Tract 9503.03, Louisa County, Virginia",1082,219,858,220,224,101
"51109950400","Census Tract 9504, Louisa County, Virginia",1219,139,1055,141,164,81
"51109950500","Census Tract 9505, Louisa County, Virginia",2630,285,2249,254,381,188
"51125950101","Census Tract 9501.01, Nelson County, Virginia",1367,226,1139,222,228,126
"51125950102","Census Tract 9501.02, Nelson County, Virginia",816,150,614,145,202,139
"51125950201","Census Tract 9502.01, Nelson County, Virginia",1064,197,848,168,216,130
"51125950202","Census Tract 9502.02, Nelson County, Virginia",1248,205,1039,183,209,116
"51125950300","Census Tract 9503, Nelson County, Virginia",1903,283,1165,156,738,249
"51065020101","Census Tract 201.01, Fluvanna County, Virginia",1969,229,1668,229,301,128
"51065020103","Census Tract 201.03, Fluvanna County, Virginia",1451,216,1207,226,244,136
"51065020104","Census Tract 201.04, Fluvanna County, Virginia",2428,161,2233,194,195,106
"51065020200","Census Tract 202, Fluvanna County, Virginia",2017,212,1483,195,534,193
"51065020300","Census Tract 203, Fluvanna County, Virginia",2102,241,1624,246,478,172
"51003010100","Census Tract 101, Albemarle County, Virginia",1988,279,1655,272,333,142
"51003010201","Census Tract 102.01, Albemarle County, Virginia",1895,167,1701,192,194,96
"51003010202","Census Tract 102.02, Albemarle County, Virginia",1165,125,1037,121,128,63
"51003010301","Census Tract 103.01, Albemarle County, Virginia",637,119,528,130,109,57
"51003010302","Census Tract 103.02, Albemarle County, Virginia",413,38,315,67,98,56
"51003010303","Census Tract 103.03, Albemarle County, Virginia",2061,174,1624,171,437,102
"51003010401","Census Tract 104.01, Albemarle County, Virginia",1903,301,1442,308,461,139
"51003010402","Census Tract 104.02, Albemarle County, Virginia",1385,164,1189,140,196,119
"51003010501","Census Tract 105.01, Albemarle County, Virginia",1054,192,883,191,171,97
"51003010502","Census Tract 105.02, Albemarle County, Virginia",1899,231,505,157,1394,283
"51003010602","Census Tract 106.02, Albemarle County, Virginia",2092,259,1373,236,719,160
"51003010603","Census Tract 106.03, Albemarle County, Virginia",1206,296,425,260,781,233
"51079030101","Census Tract 301.01, Greene County, Virginia",1522,152,1213,157,309,95
"51079030102","Census Tract 301.02, Greene County, Virginia",1880,200,1572,226,308,144
"51079030201","Census Tract 302.01, Greene County, Virginia",2675,222,2135,214,540,138
"51079030202","Census Tract 302.02, Greene County, Virginia",1414,200,1141,218,273,130
"51003010604","Census Tract 106.04, Albemarle County, Virginia",1630,201,1053,195,577,135
"51003010701","Census Tract 107.01, Albemarle County, Virginia",1370,329,259,102,1111,331
"51003010702","Census Tract 107.02, Albemarle County, Virginia",1497,165,661,184,836,204
"51003010801","Census Tract 108.01, Albemarle County, Virginia",1510,185,509,129,1001,175
"51003010802","Census Tract 108.02, Albemarle County, Virginia",983,139,366,114,617,146
"51003010901","Census Tract 109.01, Albemarle County, Virginia",740,127,171,55,569,112
"51003010904","Census Tract 109.04, Albemarle County, Virginia",537,115,50,31,487,111
"51003011000","Census Tract 110, Albemarle County, Virginia",2602,353,2310,350,292,114
"51003011101","Census Tract 111.01, Albemarle County, Virginia",806,147,671,147,135,78
"51003011102","Census Tract 111.02, Albemarle County, Virginia",1040,192,853,143,187,164
"51003011103","Census Tract 111.03, Albemarle County, Virginia",1454,152,1083,154,371,132
"51003011201","Census Tract 112.01, Albemarle County, Virginia",1734,210,1351,210,383,102
"51003011202","Census Tract 112.02, Albemarle County, Virginia",1424,173,1259,170,165,56
"51003011301","Census Tract 113.01, Albemarle County, Virginia",2152,234,1648,233,504,160
"51003011302","Census Tract 113.02, Albemarle County, Virginia",1666,215,385,116,1281,210
"51003011303","Census Tract 113.03, Albemarle County, Virginia",1613,175,793,140,820,142
"51003011400","Census Tract 114, Albemarle County, Virginia",1925,208,1526,227,399,107
